Iteration,Cost,Temperature,Sequence
0,107,300,3 9 1 2 8 4 5 7 6
1,113,299,3 9 1 2 8 5 4 7 6
2,95,298,3 2 1 9 8 5 4 7 6
3,115,297,7 2 1 9 8 5 4 3 6
4,125,296,7 2 1 9 5 8 4 3 6
5,119,295,7 2 8 9 5 1 4 3 6
6,120,294,7 2 8 9 5 6 4 3 1
7,116,293,7 4 8 9 5 6 2 3 1
8,102,292,7 4 8 9 5 6 3 2 1
9,115,291,7 4 8 9 5 6 1 2 3
10,127,290,8 4 7 9 5 6 1 2 3
11,127,289,8 4 7 9 5 6 1 2 3
12,131,288,8 4 7 9 5 6 1 3 2
13,141,287,8 4 7 9 5 3 1 6 2
14,139,286,8 4 5 9 7 3 1 6 2
15,131,285,8 4 1 9 7 3 5 6 2
16,139,284,8 3 1 9 7 4 5 6 2
17,131,283,8 3 1 4 7 9 5 6 2
18,115,282,1 3 8 4 7 9 5 6 2
19,111,281,1 3 8 4 7 9 6 5 2
20,131,280,6 3 8 4 7 9 1 5 2
21,143,279,8 3 6 4 7 9 1 5 2
22,149,278,8 3 7 4 6 9 1 5 2
23,149,277,8 3 7 1 6 9 4 5 2
24,133,276,8 3 4 1 6 9 7 5 2
25,145,275,8 3 4 9 6 1 7 5 2
26,145,274,8 3 4 2 6 1 7 5 9
27,129,273,8 3 6 2 4 1 7 5 9
28,139,272,8 1 6 2 4 3 7 5 9
29,133,271,9 1 6 2 4 3 7 5 8
30,137,270,9 1 6 8 4 3 7 5 2
31,133,269,9 1 6 8 4 3 2 5 7
32,125,268,9 1 6 8 4 2 3 5 7
33,117,267,2 1 6 8 4 9 3 5 7
34,117,266,2 1 6 8 4 9 3 5 7
35,123,265,2 1 6 8 4 7 3 5 9
36,117,264,2 1 5 8 4 7 3 6 9
37,115,263,2 1 5 8 4 7 6 3 9
38,117,262,2 1 5 6 4 7 8 3 9
39,115,261,2 1 5 8 4 7 6 3 9
40,105,260,2 1 7 8 4 5 6 3 9
41,103,259,2 1 7 8 4 5 3 6 9
42,119,258,2 1 6 8 4 5 3 7 9
43,123,257,2 8 6 1 4 5 3 7 9
44,136,256,2 8 6 1 9 5 3 7 4
45,140,255,5 8 6 1 9 2 3 7 4
46,132,254,5 8 6 4 9 2 3 7 1
47,136,253,8 5 6 4 9 2 3 7 1
48,142,252,8 5 6 4 9 3 2 7 1
49,136,251,8 5 6 4 9 2 3 7 1
50,124,250,6 5 8 4 9 2 3 7 1
51,124,249,6 5 7 4 9 2 3 8 1
52,118,248,4 5 7 6 9 2 3 8 1
53,114,247,8 5 7 6 9 2 3 4 1
54,118,246,4 5 7 6 9 2 3 8 1
55,134,245,4 5 2 6 9 7 3 8 1
56,120,244,4 5 2 6 8 7 3 9 1
57,120,243,4 5 6 2 8 7 3 9 1
58,127,242,4 1 6 2 8 7 3 9 5
59,121,241,4 9 6 2 8 7 3 1 5
60,117,240,2 9 6 4 8 7 3 1 5
61,113,239,2 5 6 4 8 7 3 1 9
62,92,238,2 5 6 9 8 7 3 1 4
63,118,237,2 5 6 9 8 3 7 1 4
64,110,236,2 5 6 9 1 3 7 8 4
65,130,235,8 5 6 9 1 3 7 2 4
66,123,234,4 5 6 9 1 3 7 2 8
67,125,233,4 5 6 9 2 3 7 1 8
68,123,232,4 5 6 9 2 7 3 1 8
69,131,231,4 8 6 9 2 7 3 1 5
70,125,230,4 6 8 9 2 7 3 1 5
71,125,229,4 6 8 9 2 7 3 1 5
72,107,228,3 6 8 9 2 7 4 1 5
73,99,227,3 6 8 9 2 5 4 1 7
74,99,226,3 6 8 9 2 4 5 1 7
75,121,225,4 6 8 9 2 3 5 1 7
76,111,224,4 6 8 9 2 1 5 3 7
77,97,223,4 7 8 9 2 1 5 3 6
78,111,222,4 5 8 9 2 1 7 3 6
79,97,221,4 7 8 9 2 1 5 3 6
80,111,220,4 7 8 5 2 1 9 3 6
81,129,219,4 7 1 5 2 8 9 3 6
82,135,218,4 7 1 9 2 8 5 3 6
83,129,217,7 4 1 9 2 8 5 3 6
84,129,216,7 4 1 9 2 8 6 3 5
85,131,215,7 4 1 5 2 8 6 3 9
86,139,214,7 4 1 5 3 8 6 2 9
87,121,213,7 4 1 5 3 2 6 8 9
88,136,212,7 9 1 5 3 2 6 8 4
89,128,211,7 9 1 5 2 3 6 8 4
90,132,210,7 9 3 5 2 1 6 8 4
91,134,209,7 3 9 5 2 1 6 8 4
92,132,208,7 1 9 5 2 3 6 8 4
93,132,207,7 1 9 5 2 3 6 8 4
94,134,206,7 1 6 5 2 3 9 8 4
95,118,205,7 1 2 5 6 3 9 8 4
96,114,204,7 4 2 5 6 3 9 8 1
97,124,203,7 4 9 5 6 3 2 8 1
98,132,202,7 1 9 5 6 3 2 8 4
99,136,201,7 1 9 6 5 3 2 8 4
100,130,200,7 3 9 6 5 1 2 8 4
101,142,199,8 3 9 6 5 1 2 7 4
102,126,198,8 5 9 6 3 1 2 7 4
103,114,197,7 5 9 6 3 1 2 8 4
104,110,196,2 5 9 6 3 1 7 8 4
105,120,195,2 5 9 8 3 1 7 6 4
106,114,194,2 5 9 8 1 3 7 6 4
107,119,193,2 5 4 8 1 3 7 6 9
108,123,192,2 5 3 8 1 4 7 6 9
109,131,191,2 5 1 8 3 4 7 6 9
110,143,190,9 5 1 8 3 4 7 6 2
111,135,189,9 5 3 8 1 4 7 6 2
112,131,188,4 5 3 8 1 9 7 6 2
113,132,187,2 5 3 8 1 9 7 6 4
114,126,186,2 5 6 8 1 9 7 3 4
115,122,185,2 5 6 1 8 9 7 3 4
116,148,184,9 5 6 1 8 2 7 3 4
117,140,183,9 7 6 1 8 2 5 3 4
118,136,182,9 7 8 1 6 2 5 3 4
119,120,181,3 7 8 1 6 2 5 9 4
120,133,180,4 7 8 1 6 2 5 9 3
121,127,179,4 9 8 1 6 2 5 7 3
122,127,178,4 9 8 2 6 1 5 7 3
123,139,177,4 5 8 2 6 1 9 7 3
124,117,176,4 5 8 9 6 1 2 7 3
125,107,175,7 5 8 9 6 1 2 4 3
126,123,174,7 5 8 9 1 6 2 4 3
127,113,173,7 5 8 9 1 6 3 4 2
128,123,172,7 5 8 9 1 6 2 4 3
129,137,171,7 5 8 4 1 6 2 9 3
130,125,170,7 6 8 4 1 5 2 9 3
131,125,169,7 6 5 4 1 8 2 9 3
132,123,168,7 6 9 4 1 8 2 5 3
133,105,167,7 6 9 8 1 4 2 5 3
134,109,166,7 6 9 8 1 4 5 2 3
135,111,165,2 6 9 8 1 4 5 7 3
136,101,164,2 6 9 3 1 4 5 7 8
137,105,163,2 6 9 1 3 4 5 7 8
138,95,162,1 6 9 2 3 4 5 7 8
139,103,161,1 6 9 2 3 4 8 7 5
140,103,160,1 6 9 4 3 2 8 7 5
141,114,159,5 6 9 4 3 2 8 7 1
142,115,158,5 6 9 4 3 1 8 7 2
143,111,157,6 5 9 4 3 1 8 7 2
144,113,156,6 5 9 3 4 1 8 7 2
145,113,155,9 5 6 3 4 1 8 7 2
146,125,154,9 5 6 7 4 1 8 3 2
147,115,153,9 5 8 7 4 1 6 3 2
148,115,152,9 8 5 7 4 1 6 3 2
149,129,151,9 8 3 7 4 1 6 5 2
150,129,150,9 2 3 7 4 1 6 5 8
151,123,149,9 2 3 6 4 1 7 5 8
152,137,148,9 2 5 6 4 1 7 3 8
153,141,147,9 2 8 6 4 1 7 3 5
154,142,146,9 2 8 6 5 1 7 3 4
155,118,145,3 2 8 6 5 1 7 9 4
156,118,144,3 2 8 6 5 1 9 7 4
157,108,143,3 2 8 7 5 1 9 6 4
158,108,142,3 2 8 7 9 1 5 6 4
159,118,141,3 2 8 1 9 7 5 6 4
160,96,140,3 2 1 8 9 7 5 6 4
161,91,139,4 2 1 8 9 7 5 6 3
162,79,138,4 2 1 9 8 7 5 6 3
163,79,137,4 2 1 9 8 7 5 6 3
164,97,136,6 2 1 9 8 7 5 4 3
165,107,135,6 2 1 3 8 7 5 4 9
166,127,134,6 2 1 8 3 7 5 4 9
167,128,133,6 2 1 8 3 7 5 9 4
168,115,132,4 2 1 8 3 7 5 9 6
169,113,131,4 2 1 9 3 7 5 8 6
170,105,130,4 2 1 3 9 7 5 8 6
171,133,129,4 2 8 3 9 7 5 1 6
172,121,128,4 2 9 3 8 7 5 1 6
173,133,127,4 2 8 3 9 7 5 1 6
174,133,126,4 2 8 3 9 7 6 1 5
175,159,125,7 2 8 3 9 4 6 1 5
176,153,124,6 2 8 3 9 4 7 1 5
177,147,123,6 2 8 3 5 4 7 1 9
178,129,122,6 5 8 3 2 4 7 1 9
179,129,121,6 1 8 3 2 4 7 5 9
180,111,120,3 1 8 6 2 4 7 5 9
181,97,119,3 7 8 6 2 4 1 5 9
182,98,118,3 7 8 6 2 4 9 5 1
183,97,117,3 7 8 6 2 4 1 5 9
184,111,116,3 1 8 6 2 4 7 5 9
185,127,115,3 8 1 6 2 4 7 5 9
186,139,114,8 3 1 6 2 4 7 5 9
187,139,113,8 3 1 6 9 4 7 5 2
188,131,112,8 7 1 6 9 4 3 5 2
189,117,111,8 7 1 2 9 4 3 5 6
190,125,110,8 5 1 2 9 4 3 7 6
191,125,109,9 5 1 2 8 4 3 7 6
192,121,108,9 5 1 2 4 8 3 7 6
193,129,107,9 6 1 2 4 8 3 7 5
194,141,106,9 6 1 3 4 8 2 7 5
195,141,105,9 7 1 3 4 8 2 6 5
196,125,104,9 7 1 3 6 8 2 4 5
197,133,103,9 1 7 3 6 8 2 4 5
198,139,102,9 1 7 3 6 4 2 8 5
199,123,101,9 1 7 8 6 4 2 3 5
200,137,100,9 1 7 8 4 6 2 3 5
201,129,99,9 1 7 8 4 6 3 2 5
202,129,98,9 1 8 7 4 6 3 2 5
203,149,97,9 1 8 3 4 6 7 2 5
204,147,96,9 1 8 3 4 6 5 2 7
205,113,95,1 9 8 3 4 6 5 2 7
206,147,94,9 1 8 3 4 6 5 2 7
207,139,93,9 1 8 3 5 6 4 2 7
208,119,92,2 1 8 3 5 6 4 9 7
209,119,91,2 1 8 3 4 6 5 9 7
210,111,90,2 1 8 3 4 9 5 6 7
211,113,89,2 1 8 3 4 9 6 5 7
212,125,88,2 1 8 3 5 9 6 4 7
213,127,87,2 8 1 3 5 9 6 4 7
214,125,86,2 9 1 3 5 8 6 4 7
215,113,85,2 9 1 3 4 8 6 5 7
216,131,84,2 9 5 3 4 8 6 1 7
217,131,83,8 9 5 3 4 2 6 1 7
218,107,82,8 9 5 3 4 2 1 6 7
219,101,81,8 9 6 3 4 2 1 5 7
220,111,80,8 5 6 3 4 2 1 9 7
221,111,79,8 5 6 3 4 2 1 9 7
222,119,78,8 5 6 3 9 2 1 4 7
223,119,77,8 5 6 3 9 1 2 4 7
224,119,76,9 5 6 3 8 1 2 4 7
225,105,75,9 8 6 3 5 1 2 4 7
226,99,74,7 8 6 3 5 1 2 4 9
227,115,73,7 8 6 1 5 3 2 4 9
228,115,72,7 8 6 1 5 3 2 4 9
229,113,71,7 8 6 2 5 3 1 4 9
230,113,70,7 8 1 2 5 3 6 4 9
231,115,69,7 8 1 2 5 9 6 4 3
232,131,68,7 8 1 9 5 2 6 4 3
233,127,67,7 8 1 3 5 2 6 4 9
234,119,66,7 8 1 3 6 2 5 4 9
235,105,65,1 8 7 3 6 2 5 4 9
236,101,64,6 8 7 3 1 2 5 4 9
237,103,63,6 8 7 3 1 2 9 4 5
238,111,62,5 8 7 3 1 2 9 4 6
239,121,61,5 8 7 1 3 2 9 4 6
240,129,60,5 8 6 1 3 2 9 4 7
241,132,59,5 8 6 1 3 2 9 7 4
242,118,58,7 8 6 1 3 2 9 5 4
243,118,57,7 8 6 2 3 1 9 5 4
244,132,56,7 8 6 2 5 1 9 3 4
245,126,55,7 8 6 2 5 1 3 9 4
246,132,54,3 8 6 2 5 1 7 9 4
247,132,53,3 8 2 6 5 1 7 9 4
248,118,52,3 2 8 6 5 1 7 9 4
249,118,51,3 2 5 6 8 1 7 9 4
250,128,50,3 5 2 6 8 1 7 9 4
251,116,49,3 5 2 6 8 7 1 9 4
252,107,48,3 5 2 6 8 7 1 4 9
253,137,47,8 5 2 6 3 7 1 4 9
254,105,46,8 5 7 6 3 2 1 4 9
255,105,45,8 5 7 6 3 2 1 4 9
256,137,44,8 5 2 6 3 7 1 4 9
257,133,43,8 5 4 6 3 7 1 2 9
258,109,42,8 5 7 6 3 4 1 2 9
259,109,41,8 5 7 6 3 4 1 2 9
260,127,40,8 2 7 6 3 4 1 5 9
261,107,39,3 2 7 6 8 4 1 5 9
262,105,38,3 1 7 6 8 4 2 5 9
263,105,37,3 1 7 6 8 5 2 4 9
264,107,36,3 2 7 6 8 5 1 4 9
265,107,35,3 2 7 6 8 5 1 4 9
266,115,34,3 2 7 6 8 1 5 4 9
267,117,33,3 2 9 6 8 1 5 4 7
268,115,32,3 2 5 6 8 1 9 4 7
269,123,31,4 2 5 6 8 1 9 3 7
270,117,30,4 2 1 6 8 5 9 3 7
271,129,29,5 2 1 6 8 4 9 3 7
272,137,28,7 2 1 6 8 4 9 3 5
273,137,27,7 2 1 6 8 4 9 3 5
274,123,26,7 2 1 6 8 9 4 3 5
275,115,25,7 2 1 5 8 9 4 3 6
276,115,24,7 4 1 5 8 9 2 3 6
277,113,23,6 4 1 5 8 9 2 3 7
278,113,22,6 4 1 5 8 9 2 3 7
279,111,21,6 4 1 3 8 9 2 5 7
280,111,20,6 4 1 3 8 9 2 5 7
281,111,19,6 5 1 3 8 9 2 4 7
282,117,18,6 5 1 3 8 4 2 9 7
283,125,17,7 5 1 3 8 4 2 9 6
284,117,16,7 5 8 3 1 4 2 9 6
285,117,15,7 5 8 3 1 4 2 9 6
286,117,14,7 5 8 3 1 4 2 9 6
287,117,13,7 5 8 3 1 4 2 9 6
288,117,12,7 5 8 4 1 3 2 9 6
289,121,11,7 5 8 4 1 3 2 6 9
290,113,10,7 9 8 4 1 3 2 6 5
291,113,9,7 9 8 4 6 3 2 1 5
292,113,8,7 9 8 4 6 3 2 1 5
293,113,7,7 9 8 4 6 3 2 1 5
294,98,6,7 9 8 5 6 3 2 1 4
295,98,5,7 9 8 5 6 3 2 1 4
296,98,4,8 9 7 5 6 3 2 1 4
297,98,3,8 9 7 5 6 3 2 1 4
298,98,2,8 9 7 5 6 3 2 1 4
299,98,1,8 9 7 5 6 3 2 1 4
