Iteration,Cost,Temperature,Sequence
0,64,10,3 11 9 1 2 8 4 12 5 7 10 6
1,64,10,3 11 9 1 2 8 4 12 5 7 10 6
2,66,10,7 11 9 1 2 8 4 12 5 3 10 6
3,62,10,7 11 6 1 2 8 4 12 5 3 10 9
4,74,10,7 11 6 1 2 9 4 12 5 3 10 8
5,73,10,7 11 6 1 2 9 4 12 5 3 8 10
6,73,10,1 11 6 7 2 9 4 12 5 3 8 10
7,79,10,1 11 6 7 5 9 4 12 2 3 8 10
8,75,10,1 11 6 7 5 9 12 4 2 3 8 10
9,73,10,1 11 12 7 5 9 6 4 2 3 8 10
