Iteration,Cost,Temperature,Sequence
0,68,10,10 3 5 2 7 12 8 11 4 6 1 9
1,74,10,10 3 1 2 7 12 8 11 4 6 5 9
2,74,10,10 3 1 2 7 12 8 11 4 6 5 9
3,78,10,10 3 1 4 7 12 8 11 2 6 5 9
4,76,10,1 3 10 4 7 12 8 11 2 6 5 9
5,86,10,11 3 10 4 7 12 8 1 2 6 5 9
6,86,10,11 6 10 4 7 12 8 1 2 3 5 9
7,90,10,11 6 10 4 7 8 12 1 2 3 5 9
8,86,10,11 6 10 4 7 12 8 1 2 3 5 9
9,86,10,11 6 10 4 12 7 8 1 2 3 5 9
