Iteration,Cost,Temperature,Sequence
0,89,300,12 10 1 11 9 2 6 4 3 7 8 5
1,77,300,12 10 1 11 4 2 6 9 3 7 8 5
2,63,300,12 8 1 11 4 2 6 9 3 7 10 5
3,85,300,12 8 1 7 4 2 6 9 3 11 10 5
4,85,300,12 3 1 7 4 2 6 9 8 11 10 5
5,85,300,12 3 1 7 4 9 6 2 8 11 10 5
6,89,300,12 3 1 8 4 9 6 2 7 11 10 5
7,89,300,12 3 1 8 10 9 6 2 7 11 4 5
8,87,300,12 3 1 8 11 9 6 2 7 10 4 5
9,77,300,12 3 1 8 11 9 6 2 7 10 5 4
10,83,300,8 3 1 12 11 9 6 2 7 10 5 4
11,84,300,8 3 1 12 11 9 6 2 4 10 5 7
12,86,300,8 3 1 12 6 9 11 2 4 10 5 7
13,84,300,2 3 1 12 6 9 11 8 4 10 5 7
14,86,300,2 3 1 8 6 9 11 12 4 10 5 7
15,78,300,2 3 1 11 6 9 8 12 4 10 5 7
16,74,300,2 3 1 11 6 9 8 4 12 10 5 7
17,78,300,2 3 7 11 6 9 8 4 12 10 5 1
18,88,300,4 3 7 11 6 9 8 2 12 10 5 1
19,96,300,4 3 7 11 6 8 9 2 12 10 5 1
20,101,300,4 3 7 11 6 8 9 2 12 1 5 10
21,91,300,4 3 1 11 6 8 9 2 12 7 5 10
22,83,300,4 3 1 11 6 9 8 2 12 7 5 10
23,82,300,4 3 1 11 6 9 8 2 10 7 5 12
24,80,300,4 3 9 11 6 1 8 2 10 7 5 12
25,66,300,9 3 4 11 6 1 8 2 10 7 5 12
26,66,300,9 3 4 11 6 1 8 2 10 7 5 12
27,72,300,9 3 4 11 6 1 5 2 10 7 8 12
28,82,300,9 3 4 8 6 1 5 2 10 7 11 12
29,100,300,9 3 1 8 6 4 5 2 10 7 11 12
30,84,300,9 3 1 8 6 4 5 7 10 2 11 12
31,82,300,9 3 6 8 1 4 5 7 10 2 11 12
32,88,300,12 3 6 8 1 4 5 7 10 2 11 9
33,98,300,12 11 6 8 1 4 5 7 10 2 3 9
34,100,300,12 10 6 8 1 4 5 7 11 2 3 9
35,97,300,12 10 6 8 1 4 9 7 11 2 3 5
36,105,300,12 10 6 8 1 4 9 7 11 5 3 2
37,95,300,12 10 11 8 1 4 9 7 6 5 3 2
38,89,300,12 10 11 9 1 4 8 7 6 5 3 2
39,85,300,3 10 11 9 1 4 8 7 6 5 12 2
40,85,300,3 10 11 9 12 4 8 7 6 5 1 2
41,81,300,3 10 11 9 6 4 8 7 12 5 1 2
42,75,300,3 10 11 9 6 7 8 4 12 5 1 2
43,83,300,3 10 11 9 6 7 8 4 5 12 1 2
44,83,300,3 10 11 9 6 7 4 8 5 12 1 2
45,90,300,2 10 11 9 6 7 4 8 5 12 1 3
46,94,300,2 10 11 9 6 7 4 5 8 12 1 3
47,92,300,2 10 11 6 9 7 4 5 8 12 1 3
48,112,300,2 10 11 6 8 7 4 5 9 12 1 3
49,108,300,2 10 11 1 8 7 4 5 9 12 6 3
50,96,300,2 10 11 1 8 3 4 5 9 12 6 7
51,88,300,2 10 11 4 8 3 1 5 9 12 6 7
52,87,300,2 7 11 4 8 3 1 5 9 12 6 10
53,89,300,2 7 9 4 8 3 1 5 11 12 6 10
54,79,300,2 7 9 4 8 3 1 5 12 11 6 10
55,77,300,2 7 9 4 8 3 6 5 12 11 1 10
56,85,300,4 7 9 2 8 3 6 5 12 11 1 10
57,85,300,4 7 9 2 8 3 5 6 12 11 1 10
58,85,300,4 7 9 2 8 3 6 5 12 11 1 10
59,93,300,4 7 9 2 8 3 6 12 5 11 1 10
60,85,300,4 7 9 2 8 3 6 5 12 11 1 10
61,87,300,4 9 7 2 8 3 6 5 12 11 1 10
62,85,300,9 4 7 2 8 3 6 5 12 11 1 10
63,85,300,9 4 7 2 8 12 6 5 3 11 1 10
64,67,300,9 6 7 2 8 12 4 5 3 11 1 10
65,65,300,9 7 6 2 8 12 4 5 3 11 1 10
66,63,300,9 7 6 10 8 12 4 5 3 11 1 2
67,65,300,9 7 6 10 8 12 4 5 3 1 11 2
68,89,300,9 12 6 10 8 7 4 5 3 1 11 2
69,91,300,10 12 6 9 8 7 4 5 3 1 11 2
70,91,300,12 10 6 9 8 7 4 5 3 1 11 2
71,67,300,7 10 6 9 8 12 4 5 3 1 11 2
72,75,300,7 10 6 9 11 12 4 5 3 1 8 2
73,71,300,7 10 6 9 11 12 4 3 5 1 8 2
74,74,300,7 10 6 9 11 12 4 3 5 2 8 1
75,71,300,7 10 6 9 11 12 4 3 5 1 8 2
76,71,300,6 10 7 9 11 12 4 3 5 1 8 2
77,81,300,6 3 7 9 11 12 4 10 5 1 8 2
78,75,300,6 3 7 9 11 12 4 10 5 8 1 2
79,77,300,11 3 7 9 6 12 4 10 5 8 1 2
80,71,300,11 3 7 9 6 1 4 10 5 8 12 2
81,67,300,11 4 7 9 6 1 3 10 5 8 12 2
82,69,300,11 4 6 9 7 1 3 10 5 8 12 2
83,78,300,11 4 6 2 7 1 3 10 5 8 12 9
84,78,300,11 4 12 2 7 1 3 10 5 8 6 9
85,91,300,11 4 12 2 7 1 3 10 9 8 6 5
86,85,300,11 4 12 2 7 10 3 1 9 8 6 5
87,71,300,11 4 12 2 7 10 3 8 9 1 6 5
88,77,300,11 4 12 2 3 10 7 8 9 1 6 5
89,77,300,11 4 12 2 3 7 10 8 9 1 6 5
90,71,300,11 4 12 2 3 7 10 6 9 1 8 5
91,75,300,11 4 12 2 3 7 8 6 9 1 10 5
92,69,300,11 4 12 2 7 3 8 6 9 1 10 5
93,77,300,11 4 12 2 7 3 8 6 9 10 1 5
94,65,300,11 4 12 2 1 3 8 6 9 10 7 5
95,91,300,11 10 12 2 1 3 8 6 9 4 7 5
96,92,300,11 10 12 2 1 3 5 6 9 4 7 8
97,96,300,11 10 12 2 6 3 5 1 9 4 7 8
98,93,300,11 10 12 2 6 3 8 1 9 4 7 5
99,87,300,2 10 12 11 6 3 8 1 9 4 7 5
100,87,300,2 10 12 11 6 3 8 1 9 7 4 5
101,95,300,2 10 12 9 6 3 8 1 11 7 4 5
102,101,300,2 10 12 1 6 3 8 9 11 7 4 5
103,79,300,2 10 12 1 6 3 7 9 11 8 4 5
104,83,300,2 10 8 1 6 3 7 9 11 12 4 5
105,84,300,2 10 8 1 5 3 7 9 11 12 4 6
106,88,300,2 12 8 1 5 3 7 9 11 10 4 6
107,96,300,2 12 3 1 5 8 7 9 11 10 4 6
108,100,300,2 12 3 1 5 7 8 9 11 10 4 6
109,82,300,2 12 3 1 5 7 8 9 6 10 4 11
110,82,300,2 12 3 1 5 7 8 9 10 6 4 11
111,80,300,2 12 3 1 5 7 10 9 8 6 4 11
112,78,300,2 12 3 1 5 10 7 9 8 6 4 11
113,86,300,2 12 7 1 5 10 3 9 8 6 4 11
114,89,300,11 12 7 1 5 10 3 9 8 6 4 2
115,95,300,11 12 7 1 2 10 3 9 8 6 4 5
116,89,300,11 12 7 1 2 9 3 10 8 6 4 5
117,79,300,11 12 7 1 2 9 3 10 8 4 6 5
118,83,300,11 12 7 1 2 9 3 10 8 5 6 4
119,83,300,11 12 2 1 7 9 3 10 8 5 6 4
120,87,300,1 12 2 11 7 9 3 10 8 5 6 4
121,89,300,9 12 2 11 7 1 3 10 8 5 6 4
122,93,300,6 12 2 11 7 1 3 10 8 5 9 4
123,101,300,6 12 2 8 7 1 3 10 11 5 9 4
124,89,300,6 12 3 8 7 1 2 10 11 5 9 4
125,85,300,6 12 3 8 7 1 9 10 11 5 2 4
126,86,300,4 12 3 8 7 1 9 10 11 5 2 6
127,70,300,4 12 3 8 7 1 9 2 11 5 10 6
128,74,300,4 12 3 6 7 1 9 2 11 5 10 8
129,70,300,4 12 3 8 7 1 9 2 11 5 10 6
130,70,300,4 12 3 8 2 1 9 7 11 5 10 6
131,70,300,4 12 3 8 2 1 7 9 11 5 10 6
132,70,300,4 12 3 8 2 1 9 7 11 5 10 6
133,75,300,4 12 3 8 2 1 9 7 11 5 6 10
134,75,300,2 12 3 8 4 1 9 7 11 5 6 10
135,73,300,2 12 3 8 5 1 9 7 11 4 6 10
136,75,300,2 12 3 8 10 1 9 7 11 4 6 5
137,77,300,2 12 11 8 10 1 9 7 3 4 6 5
138,83,300,2 12 11 8 10 3 9 7 1 4 6 5
139,84,300,2 12 11 8 10 3 9 7 1 4 5 6
140,82,300,2 12 8 11 10 3 9 7 1 4 5 6
141,90,300,2 12 1 11 10 3 9 7 8 4 5 6
142,80,300,2 12 1 11 10 6 9 7 8 4 5 3
143,80,300,2 12 7 11 10 6 9 1 8 4 5 3
144,86,300,2 12 7 11 10 6 9 4 8 1 5 3
145,86,300,2 12 7 11 10 6 9 4 8 1 5 3
146,78,300,10 12 7 11 2 6 9 4 8 1 5 3
147,78,300,10 12 7 2 11 6 9 4 8 1 5 3
148,82,300,10 12 7 2 8 6 9 4 11 1 5 3
149,98,300,10 12 7 2 8 6 9 4 3 1 5 11
150,96,300,10 2 7 12 8 6 9 4 3 1 5 11
151,102,300,12 2 7 10 8 6 9 4 3 1 5 11
152,108,300,12 7 2 10 8 6 9 4 3 1 5 11
153,90,300,12 7 3 10 8 6 9 4 2 1 5 11
154,92,300,12 7 9 10 8 6 3 4 2 1 5 11
155,92,300,8 7 9 10 12 6 3 4 2 1 5 11
156,96,300,8 7 9 10 12 6 2 4 3 1 5 11
157,86,300,8 7 9 10 12 11 2 4 3 1 5 6
158,76,300,8 1 9 10 12 11 2 4 3 7 5 6
159,78,300,8 1 9 10 2 11 12 4 3 7 5 6
160,70,300,11 1 9 10 2 8 12 4 3 7 5 6
161,66,300,6 1 9 10 2 8 12 4 3 7 5 11
162,66,300,6 1 9 10 2 8 12 4 3 7 5 11
163,62,300,6 1 9 10 2 8 4 12 3 7 5 11
164,80,300,6 8 9 10 2 1 4 12 3 7 5 11
165,78,300,4 8 9 10 2 1 6 12 3 7 5 11
166,76,300,4 8 9 10 2 1 5 12 3 7 6 11
167,86,300,12 8 9 10 2 1 5 4 3 7 6 11
168,90,300,2 8 9 10 12 1 5 4 3 7 6 11
169,86,300,2 8 3 10 12 1 5 4 9 7 6 11
170,96,300,3 8 2 10 12 1 5 4 9 7 6 11
171,78,300,1 8 2 10 12 3 5 4 9 7 6 11
172,92,300,1 8 2 10 12 11 5 4 9 7 6 3
173,92,300,2 8 1 10 12 11 5 4 9 7 6 3
174,90,300,2 8 1 10 12 9 5 4 11 7 6 3
175,86,300,2 8 1 10 9 12 5 4 11 7 6 3
176,84,300,2 8 1 10 9 3 5 4 11 7 6 12
177,82,300,2 8 1 10 9 3 11 4 5 7 6 12
178,90,300,2 8 1 10 9 3 6 4 5 7 11 12
179,88,300,2 8 1 10 9 3 6 11 5 7 4 12
180,86,300,3 8 1 10 9 2 6 11 5 7 4 12
181,81,300,3 8 1 10 9 2 6 11 5 7 12 4
182,84,300,3 8 1 10 9 2 4 11 5 7 12 6
183,84,300,3 8 1 10 9 12 4 11 5 7 2 6
184,86,300,3 8 1 11 9 12 4 10 5 7 2 6
185,96,300,3 8 1 11 9 12 4 10 2 7 5 6
186,92,300,3 8 1 11 9 4 12 10 2 7 5 6
187,98,300,3 5 1 11 9 4 12 10 2 7 8 6
188,90,300,10 5 1 11 9 4 12 3 2 7 8 6
189,83,300,10 6 1 11 9 4 12 3 2 7 8 5
190,83,300,10 6 1 11 9 4 12 7 2 3 8 5
191,73,300,10 6 1 7 9 4 12 11 2 3 8 5
192,89,300,10 11 1 7 9 4 12 6 2 3 8 5
193,83,300,6 11 1 7 9 4 12 10 2 3 8 5
194,83,300,6 11 1 10 9 4 12 7 2 3 8 5
195,73,300,6 11 1 10 9 4 12 8 2 3 7 5
196,75,300,6 10 1 11 9 4 12 8 2 3 7 5
197,77,300,6 10 2 11 9 4 12 8 1 3 7 5
198,71,300,9 10 2 11 6 4 12 8 1 3 7 5
199,77,300,9 10 5 11 6 4 12 8 1 3 7 2
200,67,300,9 10 5 11 6 1 12 8 4 3 7 2
201,75,300,9 10 5 11 7 1 12 8 4 3 6 2
202,75,300,9 10 5 11 7 1 12 4 8 3 6 2
203,77,300,9 10 12 11 7 1 5 4 8 3 6 2
204,59,300,9 10 12 5 7 1 11 4 8 3 6 2
205,59,300,9 10 12 5 7 1 6 4 8 3 11 2
206,85,300,8 10 12 5 7 1 6 4 9 3 11 2
207,77,300,8 10 12 5 7 1 6 2 9 3 11 4
208,85,300,8 10 12 5 6 1 7 2 9 3 11 4
209,81,300,6 10 12 5 8 1 7 2 9 3 11 4
210,80,300,6 10 12 5 8 1 7 2 9 3 4 11
211,74,300,6 10 12 5 8 2 7 1 9 3 4 11
212,76,300,6 10 9 5 8 2 7 1 12 3 4 11
213,76,300,6 10 9 5 8 1 7 2 12 3 4 11
214,68,300,6 10 9 5 8 7 1 2 12 3 4 11
215,68,300,6 10 9 5 8 7 1 2 12 3 4 11
216,74,300,6 10 9 5 2 7 1 8 12 3 4 11
217,74,300,6 10 9 5 2 7 1 8 12 3 4 11
218,77,300,6 10 9 5 11 7 1 8 12 3 4 2
219,67,300,6 1 9 5 11 7 10 8 12 3 4 2
220,75,300,6 1 9 5 11 7 3 8 12 10 4 2
221,93,300,6 3 9 5 11 7 1 8 12 10 4 2
222,97,300,8 3 9 5 11 7 1 6 12 10 4 2
223,92,300,8 3 9 5 11 2 1 6 12 10 4 7
224,100,300,1 3 9 5 11 2 8 6 12 10 4 7
225,90,300,1 3 9 12 11 2 8 6 5 10 4 7
226,100,300,11 3 9 12 1 2 8 6 5 10 4 7
227,104,300,5 3 9 12 1 2 8 6 11 10 4 7
228,96,300,5 3 9 11 1 2 8 6 12 10 4 7
229,80,300,5 3 9 11 1 2 10 6 12 8 4 7
230,70,300,5 6 9 11 1 2 10 3 12 8 4 7
231,84,300,5 6 9 3 1 2 10 11 12 8 4 7
232,78,300,5 6 9 3 1 2 11 10 12 8 4 7
233,84,300,5 6 9 3 12 2 11 10 1 8 4 7
234,86,300,5 6 11 3 12 2 9 10 1 8 4 7
235,100,300,5 6 11 3 10 2 9 12 1 8 4 7
236,90,300,5 6 11 3 10 2 9 12 7 8 4 1
237,88,300,5 6 11 3 10 2 4 12 7 8 9 1
238,94,300,5 6 11 3 10 2 4 12 9 8 7 1
239,87,300,5 6 11 3 1 2 4 12 9 8 7 10
240,87,300,5 6 4 3 1 2 11 12 9 8 7 10
241,83,300,6 5 4 3 1 2 11 12 9 8 7 10
242,65,300,6 5 4 9 1 2 11 12 3 8 7 10
243,73,300,6 5 4 9 1 2 11 12 3 7 8 10
244,76,300,6 5 4 9 1 2 10 12 3 7 8 11
245,76,300,6 5 4 9 1 7 10 12 3 2 8 11
246,70,300,6 12 4 9 1 7 10 5 3 2 8 11
247,64,300,9 12 4 6 1 7 10 5 3 2 8 11
248,76,300,9 7 4 6 1 12 10 5 3 2 8 11
249,68,300,9 7 4 6 1 12 10 5 3 8 2 11
250,66,300,9 7 12 6 1 4 10 5 3 8 2 11
251,72,300,9 7 12 6 1 10 4 5 3 8 2 11
252,86,300,9 2 12 6 1 10 4 5 3 8 7 11
253,90,300,2 9 12 6 1 10 4 5 3 8 7 11
254,91,300,2 9 12 6 1 10 11 5 3 8 7 4
255,81,300,2 9 10 6 1 12 11 5 3 8 7 4
256,69,300,2 9 10 6 1 11 12 5 3 8 7 4
257,68,300,2 4 10 6 1 11 12 5 3 8 7 9
258,92,300,2 4 10 6 5 11 12 1 3 8 7 9
259,99,300,9 4 10 6 5 11 12 1 3 8 7 2
260,95,300,9 4 10 6 5 11 12 1 8 3 7 2
261,95,300,9 8 10 6 5 11 12 1 4 3 7 2
262,101,300,9 8 10 6 5 11 12 1 4 7 3 2
263,97,300,9 8 10 6 5 11 12 1 3 7 4 2
264,87,300,9 8 10 6 5 11 7 1 3 12 4 2
265,101,300,9 8 10 4 5 11 7 1 3 12 6 2
266,89,300,9 8 10 4 12 11 7 1 3 5 6 2
267,78,300,9 8 10 4 12 11 2 1 3 5 6 7
268,84,300,11 8 10 4 12 9 2 1 3 5 6 7
269,74,300,11 8 6 4 12 9 2 1 3 5 10 7
270,64,300,6 8 11 4 12 9 2 1 3 5 10 7
271,56,300,2 8 11 4 12 9 6 1 3 5 10 7
272,64,300,2 8 11 3 12 9 6 1 4 5 10 7
273,70,300,2 8 11 3 12 9 4 1 6 5 10 7
274,70,300,2 8 11 3 12 9 1 4 6 5 10 7
275,76,300,2 8 11 3 10 9 1 4 6 5 12 7
276,78,300,2 8 11 3 10 7 1 4 6 5 12 9
277,76,300,2 8 5 3 10 7 1 4 6 11 12 9
278,84,300,7 8 5 3 10 2 1 4 6 11 12 9
279,92,300,7 8 5 3 10 2 9 4 6 11 12 1
280,82,300,7 8 5 3 10 9 2 4 6 11 12 1
281,74,300,1 8 5 3 10 9 2 4 6 11 12 7
282,72,300,1 10 5 3 8 9 2 4 6 11 12 7
283,86,300,1 10 6 3 8 9 2 4 5 11 12 7
284,88,300,10 1 6 3 8 9 2 4 5 11 12 7
285,86,300,10 1 6 3 8 9 2 4 5 12 11 7
286,90,300,10 3 6 1 8 9 2 4 5 12 11 7
287,90,300,10 3 6 2 8 9 1 4 5 12 11 7
288,82,300,10 9 6 2 8 3 1 4 5 12 11 7
289,72,300,10 9 6 2 1 3 8 4 5 12 11 7
290,72,300,10 9 6 2 1 12 8 4 5 3 11 7
291,82,300,10 9 6 12 1 2 8 4 5 3 11 7
292,80,300,10 9 12 6 1 2 8 4 5 3 11 7
293,74,300,10 12 9 6 1 2 8 4 5 3 11 7
294,76,300,10 12 9 6 1 2 8 4 5 11 3 7
295,76,300,4 12 9 6 1 2 8 10 5 11 3 7
296,76,300,4 3 9 6 1 2 8 10 5 11 12 7
297,77,300,4 3 9 6 1 2 8 7 5 11 12 10
298,81,300,4 3 9 6 1 5 8 7 2 11 12 10
299,81,300,4 3 9 6 1 5 8 7 12 11 2 10
