Iteration;Cost;Temperature;Sequence
0;26;100;1 2 3
1;22;90;2 1 3
2;17;81;2 3 1
3;17;72,9;2 3 1
4;27;65,61;3 2 1
5;27;59,049;3 1 2
6;27;53,1441;3 2 1
7;26;47,82969;1 2 3
8;21;43,04672;1 3 2
9;27;38,74205;3 1 2
10;27;34,86784;3 2 1
11;17;31,38106;2 3 1
12;21;28,24295;1 3 2
13;26;25,41866;1 2 3
14;27;22,87679;3 2 1
15;17;20,58911;2 3 1
16;27;18,5302;3 2 1
17;27;16,67718;3 1 2
18;27;15,00946;3 2 1
19;17;13,50851;2 3 1
20;17;12,15766;2 3 1
21;22;10,94189;2 1 3
22;22;9,847705;2 1 3
23;27;8,862934;3 1 2
24;22;7,976641;2 1 3
25;17;7,178977;2 3 1
26;17;6,461079;2 3 1
27;17;5,81497;2 3 1
28;22;5,233473;2 1 3
29;22;4,710126;2 1 3
30;22;4,239113;2 1 3
31;17;3,815202;2 3 1
32;17;3,433682;2 3 1
33;21;3,090313;1 3 2
34;17;2,781282;2 3 1
35;17;2,503154;2 3 1
36;17;2,252838;2 3 1
37;17;2,027555;2 3 1
38;17;1,824799;2 3 1
39;17;1,642319;2 3 1
40;17;1,478087;2 3 1
41;17;1,330278;2 3 1
42;17;1,19725;2 3 1
43;17;1,077525;2 3 1
44;17;0,9697728;2 3 1
45;17;0,8727955;2 3 1
46;17;0,785516;2 3 1
47;17;0,7069644;2 3 1
48;17;0,6362679;2 3 1
49;17;0,5726411;2 3 1
50;17;0,5153769;2 3 1
51;17;0,4638392;2 3 1
52;17;0,4174553;2 3 1
53;17;0,3757097;2 3 1
54;17;0,3381388;2 3 1
55;17;0,3043249;2 3 1
56;17;0,2738924;2 3 1
57;17;0,2465031;2 3 1
58;17;0,2218528;2 3 1
59;17;0,1996675;2 3 1
60;17;0,1797008;2 3 1
61;17;0,1617307;2 3 1
62;17;0,1455576;2 3 1
63;17;0,1310018;2 3 1
64;17;0,1179017;2 3 1
65;17;0,1061115;2 3 1
66;17;0,09550034;2 3 1
67;17;0,0859503;2 3 1
68;17;0,07735527;2 3 1
69;17;0,06961974;2 3 1
70;17;0,06265776;2 3 1
71;17;0,05639198;2 3 1
72;17;0,05075278;2 3 1
73;17;0,0456775;2 3 1
74;17;0,04110975;2 3 1
75;17;0,03699877;2 3 1
76;17;0,03329889;2 3 1
77;17;0,029969;2 3 1
78;17;0,0269721;2 3 1
79;17;0,02427489;2 3 1
80;17;0,0218474;2 3 1
81;17;0,01966266;2 3 1
82;17;0,0176964;2 3 1
83;17;0,01592676;2 3 1
84;17;0,01433408;2 3 1
85;17;0,01290067;2 3 1
86;17;0,0116106;2 3 1
87;17;0,01044954;2 3 1
88;17;0,009404589;2 3 1
89;17;0,008464131;2 3 1
90;17;0,007617717;2 3 1
91;17;0,006855945;2 3 1
92;17;0,006170351;2 3 1
93;17;0,005553315;2 3 1
94;17;0,004997984;2 3 1
95;17;0,004498185;2 3 1
96;17;0,004048367;2 3 1
97;17;0,00364353;2 3 1
98;17;0,003279177;2 3 1
99;17;0,002951259;2 3 1
100;17;0,002656133;2 3 1
101;17;0,00239052;2 3 1
102;17;0,002151468;2 3 1
103;17;0,001936321;2 3 1
104;17;0,001742689;2 3 1
105;17;0,00156842;2 3 1
106;17;0,001411578;2 3 1
107;17;0,00127042;2 3 1
108;17;0,001143378;2 3 1
109;17;0,00102904;2 3 1
110;17;0,000926136;2 3 1
111;17;0,0008335224;2 3 1
112;17;0,0007501701;2 3 1
113;17;0,0006751531;2 3 1
114;17;0,0006076378;2 3 1
115;17;0,000546874;2 3 1
116;17;0,0004921866;2 3 1
117;17;0,0004429679;2 3 1
118;17;0,0003986711;2 3 1
119;17;0,000358804;2 3 1
120;17;0,0003229236;2 3 1
121;17;0,0002906312;2 3 1
122;17;0,0002615681;2 3 1
123;17;0,0002354113;2 3 1
124;17;0,0002118701;2 3 1
125;17;0,0001906831;2 3 1
126;17;0,0001716148;2 3 1
127;17;0,0001544533;2 3 1
128;17;0,000139008;2 3 1
129;17;0,0001251072;2 3 1
130;17;0,0001125965;2 3 1
131;17;0,0001013368;2 3 1
132;17;9,120313E-05;2 3 1
133;17;8,208281E-05;2 3 1
134;17;7,387453E-05;2 3 1
135;17;6,648707E-05;2 3 1
136;17;5,983837E-05;2 3 1
137;17;5,385453E-05;2 3 1
138;17;4,846908E-05;2 3 1
139;17;4,362217E-05;2 3 1
140;17;3,925995E-05;2 3 1
141;17;3,533395E-05;2 3 1
142;17;3,180056E-05;2 3 1
143;17;2,86205E-05;2 3 1
144;17;2,575845E-05;2 3 1
145;17;2,31826E-05;2 3 1
146;17;2,086434E-05;2 3 1
147;17;1,877791E-05;2 3 1
148;17;1,690012E-05;2 3 1
149;17;1,52101E-05;2 3 1
150;17;1,368909E-05;2 3 1
151;17;1,232018E-05;2 3 1
152;17;1,108816E-05;2 3 1
153;17;9,979348E-06;2 3 1
154;17;8,981413E-06;2 3 1
155;17;8,083271E-06;2 3 1
156;17;7,274944E-06;2 3 1
157;17;6,54745E-06;2 3 1
158;17;5,892704E-06;2 3 1
159;17;5,303434E-06;2 3 1
160;17;4,77309E-06;2 3 1
161;17;4,295781E-06;2 3 1
162;17;3,866203E-06;2 3 1
163;17;3,479583E-06;2 3 1
164;17;3,131624E-06;2 3 1
165;17;2,818462E-06;2 3 1
166;17;2,536616E-06;2 3 1
167;17;2,282954E-06;2 3 1
168;17;2,054658E-06;2 3 1
169;17;1,849192E-06;2 3 1
170;17;1,664273E-06;2 3 1
171;17;1,497846E-06;2 3 1
172;17;1,348061E-06;2 3 1
173;17;1,213255E-06;2 3 1
174;17;1,09193E-06;2 3 1
