Iteration,Cost,Temperature,Sequence
0,205,100,12 10 1 11 9 16 2 13 6 17 14 4 3 7 8 15 5
1,195,99,6 10 1 11 9 16 2 13 12 17 14 4 3 7 8 15 5
2,193,98,6 10 1 11 9 16 14 13 12 17 2 4 3 7 8 15 5
3,193,97,6 10 1 11 9 16 14 13 12 17 2 4 3 7 8 15 5
4,201,96,6 13 1 11 9 16 14 10 12 17 2 4 3 7 8 15 5
5,201,95,6 13 1 11 9 16 14 10 12 17 2 4 3 7 8 15 5
6,207,94,6 13 1 11 9 16 14 10 12 17 2 4 3 8 7 15 5
7,189,93,6 13 1 11 9 16 12 10 14 17 2 4 3 8 7 15 5
8,173,92,6 13 1 11 9 16 12 10 15 17 2 4 3 8 7 14 5
9,187,91,6 13 1 11 9 16 12 10 15 17 2 7 3 8 4 14 5
10,197,90,6 13 1 14 9 16 12 10 15 17 2 7 3 8 4 11 5
11,191,89,6 13 2 14 9 16 12 10 15 17 1 7 3 8 4 11 5
12,189,88,6 13 2 14 9 16 1 10 15 17 12 7 3 8 4 11 5
13,167,87,6 13 2 14 9 16 1 10 15 17 12 7 3 4 8 11 5
14,169,86,6 14 2 13 9 16 1 10 15 17 12 7 3 4 8 11 5
15,172,85,6 5 2 13 9 16 1 10 15 17 12 7 3 4 8 11 14
16,204,84,6 5 2 13 10 16 1 9 15 17 12 7 3 4 8 11 14
17,216,83,6 5 2 13 10 7 1 9 15 17 12 16 3 4 8 11 14
18,210,82,6 5 2 13 4 7 1 9 15 17 12 16 3 10 8 11 14
19,206,81,6 5 2 13 4 7 1 9 15 17 16 12 3 10 8 11 14
20,228,80,6 5 2 11 4 7 1 9 15 17 16 12 3 10 8 13 14
21,211,79,6 5 2 11 4 14 1 9 15 17 16 12 3 10 8 13 7
22,215,78,6 5 2 11 4 8 1 9 15 17 16 12 3 10 14 13 7
23,215,77,6 5 2 11 4 12 1 9 15 17 16 8 3 10 14 13 7
24,213,76,6 5 2 10 4 12 1 9 15 17 16 8 3 11 14 13 7
25,203,75,6 5 2 10 1 12 4 9 15 17 16 8 3 11 14 13 7
26,207,74,6 5 2 12 1 10 4 9 15 17 16 8 3 11 14 13 7
27,195,73,6 5 2 12 1 10 4 9 15 17 16 3 8 11 14 13 7
28,197,72,6 5 2 12 1 10 4 9 15 17 16 3 8 11 13 14 7
29,207,71,6 5 2 12 14 10 4 9 15 17 16 3 8 11 13 1 7
30,197,70,6 5 13 12 14 10 4 9 15 17 16 3 8 11 2 1 7
31,187,69,6 5 13 12 14 10 4 9 15 17 3 16 8 11 2 1 7
32,211,68,6 8 13 12 14 10 4 9 15 17 3 16 5 11 2 1 7
33,211,67,6 8 13 12 2 10 4 9 15 17 3 16 5 11 14 1 7
34,215,66,6 8 4 12 2 10 13 9 15 17 3 16 5 11 14 1 7
35,231,65,6 8 15 12 2 10 13 9 4 17 3 16 5 11 14 1 7
36,221,64,6 8 15 12 2 10 13 9 11 17 3 16 5 4 14 1 7
37,223,63,6 8 15 12 2 10 13 9 16 17 3 11 5 4 14 1 7
38,223,62,6 8 15 12 2 10 13 9 16 17 3 11 5 14 4 1 7
39,223,61,6 8 15 12 2 10 13 9 16 17 3 11 5 14 4 1 7
40,215,60,6 8 15 12 2 10 13 5 16 17 3 11 9 14 4 1 7
41,211,59,6 8 15 12 17 10 13 5 16 2 3 11 9 14 4 1 7
42,229,58,10 8 15 12 17 6 13 5 16 2 3 11 9 14 4 1 7
43,221,57,10 8 15 12 17 13 6 5 16 2 3 11 9 14 4 1 7
44,197,56,10 8 16 12 17 13 6 5 15 2 3 11 9 14 4 1 7
45,209,55,10 8 16 6 17 13 12 5 15 2 3 11 9 14 4 1 7
46,203,54,10 8 16 2 17 13 12 5 15 6 3 11 9 14 4 1 7
47,203,53,10 8 16 2 17 13 12 5 15 6 3 11 9 14 4 1 7
48,210,52,10 8 16 2 17 13 12 5 15 6 3 11 9 14 4 7 1
49,210,51,11 8 16 2 17 13 12 5 15 6 3 10 9 14 4 7 1
50,222,50,11 8 16 12 17 13 2 5 15 6 3 10 9 14 4 7 1
51,222,49,11 8 16 12 17 13 2 5 15 6 3 10 9 4 14 7 1
52,222,48,11 8 16 12 17 13 2 5 15 6 3 10 4 9 14 7 1
53,222,47,8 11 16 12 17 13 2 5 15 6 3 10 4 9 14 7 1
54,250,46,8 13 16 12 17 11 2 5 15 6 3 10 4 9 14 7 1
55,252,45,8 13 15 12 17 11 2 5 16 6 3 10 4 9 14 7 1
56,258,44,8 13 15 12 17 11 2 5 16 7 3 10 4 9 14 6 1
57,224,43,2 13 15 12 17 11 8 5 16 7 3 10 4 9 14 6 1
58,220,42,10 13 15 12 17 11 8 5 16 7 3 2 4 9 14 6 1
59,203,41,10 13 15 12 17 11 8 5 16 1 3 2 4 9 14 6 7
60,203,40,10 13 15 12 17 11 8 5 16 1 3 2 4 9 14 6 7
61,205,39,10 13 15 12 17 11 6 5 16 1 3 2 4 9 14 8 7
62,223,38,10 6 15 12 17 11 13 5 16 1 3 2 4 9 14 8 7
63,223,37,10 6 15 12 17 11 13 5 16 1 3 2 4 9 14 8 7
64,223,36,10 6 15 12 17 11 13 5 16 1 3 2 4 9 14 8 7
65,219,35,10 6 15 12 17 11 13 14 16 1 3 2 4 9 5 8 7
66,229,34,14 6 15 12 17 11 13 10 16 1 3 2 4 9 5 8 7
67,215,33,14 6 15 12 17 1 13 10 16 11 3 2 4 9 5 8 7
68,205,32,14 5 15 12 17 1 13 10 16 11 3 2 4 9 6 8 7
69,201,31,14 5 15 12 17 1 13 10 16 4 3 2 11 9 6 8 7
70,201,30,14 5 15 12 17 1 13 3 16 4 10 2 11 9 6 8 7
71,201,29,14 5 15 12 11 1 13 3 16 4 10 2 17 9 6 8 7
72,199,28,14 2 15 12 11 1 13 3 16 4 10 5 17 9 6 8 7
73,203,27,14 2 15 12 11 1 13 3 16 4 10 5 7 9 6 8 17
74,193,26,14 2 8 12 11 1 13 3 16 4 10 5 7 9 6 15 17
75,205,25,14 2 8 12 11 1 13 3 16 4 17 5 7 9 6 15 10
76,195,24,14 2 8 12 11 1 3 13 16 4 17 5 7 9 6 15 10
77,190,23,10 2 8 12 11 1 3 13 16 4 17 5 7 9 6 15 14
78,180,22,10 2 8 12 11 1 3 13 16 4 17 15 7 9 6 5 14
79,180,21,10 2 8 12 11 1 3 13 16 4 17 15 7 9 6 5 14
80,180,20,10 2 8 12 11 1 3 13 16 4 17 15 7 9 6 5 14
81,176,19,10 2 8 12 11 4 3 13 16 1 17 15 7 9 6 5 14
82,176,18,10 2 8 9 11 4 3 13 16 1 17 15 7 12 6 5 14
83,176,17,10 2 8 9 11 4 3 13 16 1 17 15 6 12 7 5 14
84,176,16,10 2 8 9 11 4 3 13 16 1 17 15 6 12 7 5 14
85,176,15,10 2 8 9 11 4 3 13 16 1 17 15 6 12 7 5 14
86,176,14,10 2 8 9 11 4 3 13 16 1 17 15 6 12 7 5 14
87,174,13,10 2 8 9 11 4 3 13 16 1 17 15 5 12 7 6 14
88,174,12,10 2 8 9 11 4 3 13 16 1 17 15 5 12 7 6 14
89,175,11,10 2 8 9 11 4 3 13 16 1 17 15 5 14 7 6 12
90,171,10,1 2 8 9 11 4 3 13 16 10 17 15 5 14 7 6 12
91,171,9,1 2 8 9 11 4 3 13 16 10 17 15 5 14 7 6 12
92,179,8,1 2 8 9 11 4 3 13 16 17 10 15 5 14 7 6 12
93,179,7,1 2 8 9 11 4 3 13 16 17 10 15 5 14 7 6 12
94,179,6,1 2 8 9 11 4 3 13 16 17 10 15 5 14 7 6 12
95,179,5,1 2 8 9 11 4 3 13 16 17 10 15 5 14 7 6 12
96,175,4,1 2 6 9 11 4 3 13 16 17 10 15 5 14 7 8 12
97,175,3,1 2 6 9 11 4 3 13 16 17 10 15 5 14 7 8 12
98,175,2,1 2 6 9 11 4 3 13 16 17 10 15 5 14 7 8 12
99,175,1,1 2 6 9 11 4 3 13 16 17 10 15 5 14 7 8 12
